20
41
1111111111111111111111111111111111111111
1G........................1........1..G1
1.11111111.111.1.111111.1...11.111...1.1
1..1000001.11..1.100001.11111....1.111.1
11.1111111.1..1..100001.1.....11.1.111.1
1...............1100001...1.1111.......1
11.1111111.1111.1111111.111.1111.11111.1
1..1000001.1.....................1.....1
1.11111111.1.1.1111--1111.111111...1...1
1..........1.1.1110000111.100001.111.111
1111111111.....111BCIP111.100001...1...1
1..........111.1111111111.100001.1...1.1
1.........................111111.1.111.1
1..........1..11.11111.11..............1
1111111111.11.11.......111..1111.1.1.111
1..............11.111.1..........1.....1
1.11111.1.1111..........11111111.1.111.1
1.11111.1.1001.11110111.10000001.1...1.1
1G........1001....020...10000001...1..G1
1111111111111111111111111111111111111111
