28
27
111111111111111111111111111
1.........................1
1.1111.11.1111111.1111111.1
1.1111.11.1000001.1000001.1
1......11.1000001.1000001.1
1.1111111.1000001.1000001.1
1.1111101.1111111.1000001.1
1.....101.........1000001.1
1.111G111.1111111G1111111.1
1.........................1
1.1111111.1111111.1111111.1
1.1000001.1000001.1000001.1
1.1000001.1000001.1100001.1
1.1000001.1000001..100001.1
1.1000001.1111111..111111.1
1.1111111..............11.1
1.........11---11.1111....1
1.1111111.1000001.1001111.1
1.1000001.1BCIP01.1000001.1
1.1000001.1000001.1111101.1
1.1000001.1000001.....101.1
1.1000001.1111111.111G111.1
1.1000001.................1
1.1000001.1111111.1111111.1
1.1001111.1100001.1000001.1
1.1111.....111111.1111111.1
1G.....111...........2....1
111111111111111111111111111
