31
28
1111111111111111111111111111
1............11............1
1.1111.11111.11.11111.1111.1
1.1001.10001.11.10001.1001.1
1.1111.11111.11.11111.1111.1
1..........................1
1.1111.11.11111111.11.1111.1
1.1111.11.11111111.11.1111.1
1......11....11....11......1
111111.11111.11.11111.111111
000001.11111.11.11111.100000
000001.11..........11.100000
000001.11.111--111.11.100000
111111.11.11000011.11.100000
12........11BCIP11....100000
111111.11.11111111.11.100000
000001.11.11111111.11.100000
000001.11..........11.100000
000001.11.11111111.11.100000
111111.11.11111111.11.111111
1.........G..11............1
1.1111.11111.11.11111.1111.1
1.1111.11111.11.11111.1111.1
1...11................11...1
111.11.11.11111111.11.11.111
111.11.11.11111111.11.11.111
1......11....11....11......1
1.1111111111.11.1111111111.1
1.1111111111.11.1111111111.1
1..........................1
1111111111111111111111111111
